H H H H H H H H H H H H H H A A A A H H
W H H H H H H H H H H H H A A A A H H H
W W H H H H H H H H H H A W A W H H H H
W W W A H H H H H H H H H W A W H H H H
W W A A A H H H H H H H H W W W H H H H
W W A A H H H H H H H H H H W W H H H H
W H A H H H H H H H H H H H H H H H H H
W H H H H H H H H H H H H H H H H H H H
H H H H H H H H H H H H H H H H A H H H
H H H H H H H H H H H H H H H A A H H H
H W H W H H H H H H H H H H A A A A A H
A W W W W H H H H H H H H H H A A A H H
A A W W W W H H H H H H H H H H A H H H
A A W W W W H H H H H H H H H H H H H H
A H H W W H H H H H H H H H H H H H H H
W W W A H H H H H H H H H W A W H H H H
W W A A A H H H H H H H H W W W H H H H
W W A A H H H H H H H H H H W W H H H H
W H A H H H H H H H H H H H H H H H H H
W H H H H H H H H H H H H H H H H H H H
W W W A H H H H H H H H H W A W H H H H
W W A A A H H H H H H H H W W W H H H H
W H H H H H H H H H H H H H H H H H H H
H H H H H H H H H H H H H H H H A H H H
H H H H H H H H H H H H H H H A A H H H
H W H W H H H H H H H H H H A A A A A H
A W W W W H H H H H H H H H H A A A H H
A A W W W W H H H H H H H H H H A H H H
A A W W W W H H H H H H H H H H H H H H
A H H W W H H H H H H H H H H H H H H H
W W W A H H H H H H H H H W A W H H H H